---E---G-F
----E---E-
--G-G-G---
--E--G--E-
-G--E--G--
E----E--G-
-E-G--G---
----G---E-
-G---G--E-
---G---G--